9 9 11 6 4 4 4 4 4 4 4 4 4 0 0 0
9 9 11 8 4 4 4 4 4 4 4 4 0 0 0 0
9 9 9 12 6 4 4 4 4 4 4 0 0 0 0 0
9 9 9 11 8 4 4 4 4 4 0 0 0 0 0 0
9 9 9 9 10 8 4 4 4 0 0 0 0 0 0 0
9 9 9 9 9 12 6 4 0 0 0 0 0 0 0 0
9 9 9 9 9 11 2 0 0 0 0 0 0 0 0 0
9 9 9 9 11 2 0 0 0 0 0 0 0 0 0 0
9 9 9 9 11 3 1 1 0 0 0 0 0 0 0 0
9 9 9 9 9 10 10 12 2 0 0 0 0 0 0 0
9 9 9 9 9 9 9 11 3 1 1 1 1 1 1 1 
9 9 9 9 9 9 9 9 10 10 10 10 10 10 10 10